R                   1200                         600
NO          ./textures/north.xpm                
WE     ./textures/west.xpm             
SO         ./textures/south.xpm              
EA ./textures/east.xpm
S                    ./textures/barrel.xpm             

F                       32   ,   32   ,    32
C        255   ,   0   ,   0



        1111111111111111111111111
        1000000000110000000000001
        1011000001110200S02000001
        1001000200000000000020001
111111111011000001110002000000001
100000000011000001110111111111111
111101111111110111000000100011111
111111111101110101001000111000001
110101011100000010001100020000001
100011000000100011000200000000001
11010100100011100000111010101111111
110001111111011 111011 1011111111
111111111111111 1111111 111111111